0, 0, 1110;0, 1, 1010;0, 2, 0110;0, 3, 1010;0, 4, 0010;0, 5, 0010;0, 6, 0011;0, 7, 0011;0, 8, 0110;
1, 0, 1100;1, 1, 1100;1, 2, 1100;1, 3, 1100;1, 4, 1100;1, 5, 1001;1, 6, 0010;1, 7, 0010;1, 8, 0100;
2, 0, 1001;2, 1, 0101;2, 2, 1001;2, 3, 0100;2, 4, 1000;2, 5, 0010;2, 6, 0101;2, 7, 1100;2, 8, 1100;
3, 0, 1010;3, 1, 0010;3, 2, 0011;3, 3, 0001;3, 4, 0001;3, 5, 0101;3, 6, 1010;3, 7, 0101;3, 8, 1100;
4, 0, 1101;4, 1, 1100;4, 2, 1010;4, 3, 0011;4, 4, 0011;4, 5, 0110;4, 6, 1100;4, 7, 1010;4, 8, 0101;
5, 0, 1010;5, 1, 0100;5, 2, 1100;5, 3, 1011;5, 4, 0110;5, 5, 1001;5, 6, 0101;5, 7, 1100;5, 8, 1110;
6, 0, 1100;6, 1, 1101;6, 2, 1001;6, 3, 0110;6, 4, 1000;6, 5, 0110;6, 6, 1010;6, 7, 0001;6, 8, 0101;
7, 0, 1100;7, 1, 1010;7, 2, 0110;7, 3, 1001;7, 4, 0101;7, 5, 1001;7, 6, 0001;7, 7, 0011;7, 8, 0110;
8, 0, 1001;8, 1, 0101;8, 2, 1001;8, 3, 0011;8, 4, 0011;8, 5, 0011;8, 6, 0011;8, 7, 0011;8, 8, 0101;
