0, 0, 1110;0, 1, 1011;0, 2, 0010;0, 3, 0010;0, 4, 0110;0, 5, 1010;0, 6, 0110;0, 7, 1010;0, 8, 0110;
1, 0, 1001;1, 1, 0011;1, 2, 0101;1, 3, 1000;1, 4, 0100;1, 5, 1100;1, 6, 1001;1, 7, 0000;1, 8, 0100;
2, 0, 1010;2, 1, 0011;2, 2, 0010;2, 3, 0001;2, 4, 0100;2, 5, 1000;2, 6, 0011;2, 7, 0000;2, 8, 0100;
3, 0, 1100;3, 1, 1110;3, 2, 1001;3, 3, 0010;3, 4, 0000;3, 5, 0000;3, 6, 0010;3, 7, 0001;3, 8, 0100;
4, 0, 1100;4, 1, 1100;4, 2, 1010;4, 3, 0101;4, 4, 1100;4, 5, 1001;4, 6, 0000;4, 7, 0011;4, 8, 0101;
5, 0, 1000;5, 1, 0000;5, 2, 0100;5, 3, 1010;5, 4, 0000;5, 5, 0010;5, 6, 0001;5, 7, 0011;5, 8, 0110;
6, 0, 1000;6, 1, 0101;6, 2, 1000;6, 3, 0000;6, 4, 0100;6, 5, 1100;6, 6, 1110;6, 7, 1010;6, 8, 0100;
7, 0, 1000;7, 1, 0010;7, 2, 0001;7, 3, 0100;7, 4, 1000;7, 5, 0001;7, 6, 0100;7, 7, 1100;7, 8, 1100;
8, 0, 1001;8, 1, 0001;8, 2, 0011;8, 3, 0001;8, 4, 0001;8, 5, 0111;8, 6, 1001;8, 7, 0101;8, 8, 1101;
